1,S,1,1,1,1,1,1,1,1,1,1,1,1,1,1,1,1,1,1,1,1,1,1,1,1,1,1,1,1,1,1
1,C,0,C,C,0,C,0,C,0,C,C,O,C,0,0,O,O,0,0,O,0,0,0,O,O,0,O,O,O,0,1
1,C,1,1,1,1,1,1,1,1,1,1,1,1,1,1,1,1,1,1,1,1,1,1,1,1,1,1,1,1,1,1
1,C,1,0,O,0,O,1,O,0,0,1,O,1,1,1,1,1,1,1,1,1,1,1,1,1,1,1,1,1,0,1
1,C,1,1,0,1,O,O,O,0,0,1,0,1,O,0,0,0,0,0,0,0,O,O,0,0,O,1,0,0,0,1
1,C,1,1,O,1,O,1,1,1,1,1,0,1,O,1,1,1,1,1,1,1,1,1,1,1,0,1,0,1,1,1
1,C,1,0,0,O,0,0,0,O,0,0,0,1,0,1,0,0,0,0,0,0,0,0,0,1,O,1,0,0,0,1
1,C,1,1,1,O,1,O,1,0,1,1,1,1,0,1,0,1,1,1,1,1,1,1,0,1,0,1,0,1,1,1
1,C,1,0,0,0,1,0,1,0,0,0,O,1,O,1,0,1,O,O,O,0,0,1,0,1,0,1,0,0,0,1
1,C,1,0,1,0,1,0,1,0,1,1,0,1,O,1,0,1,O,O,O,1,0,1,0,1,0,1,0,1,1,1
1,0,1,O,1,0,1,0,0,O,0,1,0,1,0,1,0,1,O,O,O,1,0,1,0,1,O,1,0,0,0,1
1,C,1,0,1,1,1,0,1,0,1,1,0,1,0,1,0,0,O,O,O,1,E,1,0,1,O,1,1,1,0,1
1,0,1,0,0,0,1,0,1,1,1,1,O,1,O,1,1,1,1,1,1,1,1,1,0,1,0,1,0,1,0,1
1,0,1,1,1,1,1,O,0,O,0,0,0,1,O,O,0,0,0,0,0,O,0,O,O,O,0,O,0,0,0,1
1,0,0,0,0,O,0,O,1,1,1,1,O,1,O,1,1,1,0,1,1,1,1,1,1,1,1,1,1,1,1,1
1,0,1,0,1,1,1,0,1,0,0,1,0,1,0,1,0,1,0,1,O,0,O,0,0,O,0,O,0,0,O,1
1,0,O,0,1,0,1,0,1,0,0,1,O,1,0,1,0,1,1,1,0,1,1,1,1,1,1,1,1,1,0,1
1,0,1,1,1,0,1,0,1,O,0,1,0,1,O,1,0,0,0,0,0,0,O,0,0,O,1,O,0,0,0,1
1,0,0,1,0,0,0,O,1,O,1,1,0,1,0,1,1,1,1,1,1,1,1,1,1,0,1,0,1,1,0,1
1,0,O,0,1,1,1,0,1,O,0,0,O,1,0,O,0,0,0,O,0,0,0,O,0,0,1,0,0,1,O,1
1,0,0,0,O,0,1,0,1,1,1,1,1,1,1,1,1,1,1,1,1,1,1,1,1,1,1,1,0,1,0,1
1,0,O,1,0,1,1,0,1,0,0,0,1,O,0,O,0,O,0,0,O,0,O,0,O,0,O,0,O,1,0,1
1,0,0,1,0,0,1,0,0,0,1,0,0,O,0,O,0,O,0,O,0,O,0,O,0,O,0,O,0,0,0,1
1,1,1,1,1,1,1,1,1,1,1,1,1,1,1,1,1,1,1,1,1,1,1,1,1,1,1,1,1,1,1,1